ribnjak	n
dostupnost	n
deformacija	n
antioksidans	n
zapis	n
kvadrat	n
presedan	n
zapremnina	n
prerada	n
general	ž
vlas	n
pristojba	n
osnova	n
porta	n
ekstrem	n
domoljublje	n
pandemija	n
glavnica	n
odijelo	n
alkoholizam	n
pakt	n
letenje	n
bronca	n
dokaz	n
stereo	n
kockica	n
odraz	n
mikser	n
povraćanje	n
karizma	n
kalvarija	n
milja	n
okolina	n
postojanje	n
buđenje	n
omalovažavanje	n
negativac	ž
trk	n
socijalizam	n
klavir	n
prijavljivanje	n
štala	n
patrola	n
šivanje	n
sekcija	n
valjak	n
padalina	n
planiranje	n
neven	n
mrvica	n
protivnica	ž
editorijal	n
štovatelj	ž
pozadina	n
mentor	ž
taliban	ž
dušik	n
pravljenje	n
prijenos	n
zamolba	n
disk	n
uspjeh	n
prošlost	n
sloboda	n
sedamdesete	n
pravopis	n
uradak	n
stabljika	n
ženidba	n
pregovor	n
gnijezdo	n
pripovijest	n
krvarenje	n
fobija	n
novčić	n
rejting	n
potrošnja	n
lončar	ž
mirenje	n
poslodavac	ž
normalizacija	n
poznavanje	n
neodgovornost	n
komplet	n
muslimanka	ž
konkurentnost	n
isplata	n
biskupija	n
prijelaz	n
ulomak	n
čovjek	ž
stečevina	n
kasa	n
reket	n
foton	n
prihod	n
nepogoda	n
tabela	n
padobranac	ž
violinist	ž
uvježbavanje	n
valjanost	n
boljitak	n
rana	n
kiosk	n
veterinar	ž
kovač	ž
trajanje	n
blamaža	n
služenje	n
kustos	ž
zec	ž
polijetanje	n
uho	n
delegat	ž
kolegica	ž
znanstvenica	ž
promišljanje	n
duhan	n
sudnica	n
aerodrom	n
invalidnost	n
mulj	n
krivnja	n
statut	n
zajednica	n
susjeda	ž
otplata	n
ekstrakt	n
nagrada	n
raspad	n
hit	n
dokazivanje	n
povlačenje	n
mjesec	n
nakana	n
monopol	n
njuška	n
nužda	n
duel	n
dominacija	n
oštrina	n
položaj	n
stočar	ž
manevar	n
specijalitet	n
antitijelo	n
udruživanje	n
posebnost	n
šutnja	n
kostim	n
rosa	n
uvjerljivost	n
opstrukcija	n
kamen	n
lavanda	n
trećina	n
pojačanje	n
porijeklo	n
recikliranje	n
jal	n
blagodat	n
predznanje	n
povik	n
koncentracija	n
spodoba	n
prizvuk	n
galerija	n
poslovnik	n
napuštanje	n
infrastruktura	n
plijen	n
kontroler	n
popuštanje	n
panj	n
uživanje	n
talog	n
mučenje	n
tona	n
suradnica	ž
vikend	n
kokos	n
razlikovanje	n
simptom	n
parlament	n
sanacija	n
retrospektiva	n
povlastica	n
preferencija	n
sport	n
trokut	n
iscrpljenost	n
brošura	n
bilješka	n
podatak	n
izvanzemaljac	ž
pljačkaš	ž
punjač	n
počinak	n
pojavljivanje	n
težak	ž
madrac	n
dozvola	n
siromah	ž
solidarnost	n
učesnik	ž
djevica	ž
trojstvo	n
struka	n
upad	n
mobitel	n
vinogradar	ž
predavač	ž
napajanje	n
brava	n
stanovanje	n
trg	n
žarulja	n
štovanje	n
blagovaonica	n
uš	ž
naivnost	n
pohrana	n
dobrodošlica	n
obožavatelj	ž
prekid	n
komanda	n
tvrdoća	n
pročelje	n
pritisak	n
predstojnik	ž
haljinica	n
pokrivenost	n
deva	ž
pozicioniranje	n
izložba	n
tvorac	ž
institucija	n
piletina	n
predložak	n
reagiranje	n
kriterij	n
hijerarhija	n
pivovara	n
premijera	n
trgovina	n
kalendar	n
trudnoća	n
ubojica	ž
nacionalnost	n
metafora	n
negiranje	n
svijest	n
vuča	n
zbrinjavanje	n
prinos	n
zelje	n
pojava	n
otopina	n
remont	n
sramota	n
glazura	n
decembar	n
sram	n
petrokemija	n
kipar	ž
propuštanje	n
savršenstvo	n
psiholog	ž
turizam	n
rođenje	n
ravnopravnost	n
nalaženje	n
svjedodžba	n
kontrola	n
svrbež	n
mir	n
poredak	n
autogram	n
nebo	n
breza	n
pješačenje	n
operacija	n
zastupanje	n
pomorac	ž
stereotip	n
pobožnost	n
nadimak	n
neistomišljenik	ž
dekolte	n
agresija	n
prostitutka	ž
gat	n
tečaj	n
beton	n
okruženje	n
infuzija	n
stvarčica	n
grožđe	n
odrednica	n
strijela	n
umjetnik	ž
samoubojica	ž
arhitektura	n
kolač	n
nasljeđivanje	n
nikotin	n
istup	n
osmijeh	n
spuštanje	n
sporazum	n
poremećaj	n
kemoterapija	n
raskrižje	n
rob	ž
pomagač	ž
besmislica	n
prostranstvo	n
optuženi	ž
termostat	n
ugljik	n
korištenje	n
crtica	n
mišljenje	n
dopisnik	ž
eksperiment	n
jezik	n
pretjerivanje	n
maestro	ž
tržnica	n
razina	n
paravan	n
početnik	ž
obećanje	n
žbuka	n
kandidat	ž
efikasnost	n
potok	n
mješavina	n
reinkarnacija	n
popunjenost	n
visina	n
prvenstvo	n
stvaratelj	ž
nacrt	n
intervju	n
sretnik	ž
priprema	n
izabranik	ž
saga	n
uzrečica	n
suosjećanje	n
avantura	n
opraštanje	n
osjećanje	n
curenje	n
stavak	n
epilog	n
kupač	ž
kunić	ž
autoput	n
dečko	ž
ekosustav	n
košarkaš	ž
podnožje	n
svojstvo	n
popravljanje	n
avenija	n
apstrakcija	n
nošnja	n
nosač	ž
šešir	n
jednostavnost	n
isključivanje	n
zet	ž
književnik	ž
nastavnik	ž
tradicija	n
plašt	n
trnje	n
usamljenost	n
čunj	n
ulaz	n
doktrina	n
prodavačica	ž
pikado	n
kuhar	ž
sob	ž
šampon	n
dvorište	n
kandidatura	n
unos	n
obnavljanje	n
rebro	n
ljuska	n
inventar	n
provjera	n
ležaljka	n
debitant	ž
migrena	n
rješenje	n
vještačenje	n
republikanac	ž
načelo	n
valcer	n
ljestvica	n
ostatak	n
opruga	n
islam	n
havarija	n
sučelje	n
ograničenje	n
osjetilo	n
kombi	n
pomagalo	n
religija	n
čarolija	n
džamija	n
čekanje	n
sprječavanje	n
segment	n
gospodin	ž
religioznost	n
jadnik	ž
biralište	n
rez	n
kuglana	n
tračnica	n
dinastija	n
pripajanje	n
ženstvenost	n
ispostava	n
školjka	OBA
volan	n
destinacija	n
odbitak	n
individualac	ž
saslušanje	n
status	n
prikaz	n
ubojstvo	n
skripta	n
ulazak	n
prednost	n
školarac	ž
ugostitelj	ž
mješanac	ž
lijek	n
opravdanost	n
rat	n
državljanstvo	n
križaljka	n
pokrivanje	n
ventil	n
kadulja	n
vodovod	n
tetovaža	n
pejzaž	n
brodogradilište	n
mito	n
kupovanje	n
vir	n
traženje	n
gips	n
kamenje	n
filter	n
dobrovoljac	ž
milost	n
prehrana	n
cirkus	n
nepostojanje	n
inat	n
šablona	n
slikarica	ž
oprost	n
očaj	n
kronologija	n
pedagoginja	ž
konverzija	n
škola	n
bat	n
neugodnost	n
konstatacija	n
strast	n
pjenušac	n
proizvod	n
magistar	ž
sudbina	n
kloniranje	n
reguliranje	n
bilijun	n
moćnik	ž
četverac	n
klijent	ž
borbenost	n
klik	n
poglavarstvo	n
ophođenje	n
kino	n
instaliranje	n
prolaznost	n
neslaganje	n
unošenje	n
pripravak	n
vojarna	n
džungla	n
predlagatelj	ž
telefoniranje	n
teza	n
taekwondo	n
bakalar	OBA
mržnja	n
implantat	n
majmun	ž
medicina	n
produženje	n
starost	n
srijeda	n
zadovoljština	n
pipa	n
biolog	ž
policija	n
epoha	n
losos	ž
gutljaj	n
objektiv	n
pristup	n
šalter	n
prvakinja	ž
komentiranje	n
isključenje	n
kip	n
svjetionik	n
samopoštovanje	n
malenkost	n
seljačina	ž
para	n
računovodstvo	n
razglednica	n
uloga	n
ustanova	n
opravdanje	n
dinosaur	ž
gospa	ž
računarstvo	n
skladatelj	ž
boleština	n
laik	ž
podrum	n
obred	n
drenaža	n
ohrabrenje	n
leukemija	n
pidžama	n
kreacija	n
prijava	n
rupa	n
postavljanje	n
gulaš	n
roman	n
posluživanje	n
simpatija	ž
nadzornik	ž
jakna	n
prase	ž
pozivnica	n
imanje	n
šesnaesterac	n
top	n
bjegunac	ž
namjera	n
vinogradarstvo	n
ispravak	n
karijes	n
primat	n
greška	n
psihoza	n
alarm	n
grudnjak	n
napon	n
pećnica	n
palma	n
primjer	n
muž	ž
pedofil	ž
građanka	ž
preglednost	n
stablo	n
menadžer	ž
puding	n
krokodil	ž
otpad	n
ludost	n
silovanje	n
sprint	n
srdela	ž
kontrakcija	n
pastor	ž
protein	n
dokumentarac	n
oblikovanje	n
suvenir	n
šljiva	n
svadba	n
namještanje	n
razmak	n
zub	n
popunjavanje	n
vol	ž
grozd	n
štitnjača	n
zakon	n
netrpeljivost	n
kalkulator	n
obitelj	n
obmana	n
znanje	n
uspostava	n
gliser	n
jastuk	n
mirovanje	n
ponuditelj	ž
fluid	n
aktivacija	n
okov	n
biciklijada	n
obala	n
jarak	n
satnica	n
kvantiteta	n
korektor	n
tvrđava	n
televizor	n
brigadir	n
mehanizam	n
naručivanje	n
mikroskop	n
razvod	n
istina	n
savjest	n
operativac	ž
usmjerenje	n
trgovanje	n
prenamjena	n
težište	n
inozemstvo	n
mehanika	n
zavist	n
odvjetništvo	n
raskršće	n
sestrična	ž
osobina	n
recepcija	n
zemljovid	n
vizionar	ž
konzulat	n
pobuda	n
domena	n
zanimacija	n
kasta	n
škrinja	n
zamisao	n
slovo	n
duhovnost	n
željezničar	ž
lopatica	n
alibi	n
čovječanstvo	n
vrijeme	n
pristanište	n
kancelarija	n
telefon	n
zavođenje	n
varanje	n
kupoprodaja	n
znamenka	n
smijeh	n
kandidatkinja	ž
podmirenje	n
teren	n
rekreacija	n
dizajnerica	ž
vesta	n
opredjeljenje	n
val	n
trzaj	n
novac	n
diktat	n
nedoumica	n
olakšanje	n
konzultacija	n
nevjesta	ž
vrećica	n
filtriranje	n
polovica	n
teorija	n
skakanje	n
disertacija	n
sunčanje	n
šteta	n
drek	n
dopuštenje	n
atelje	n
telekom	n
poljubac	n
snalaženje	n
knez	ž
hlače	n
praćenje	n
izuzetak	n
promil	n
vjenčanica	n
ovrha	n
gljivica	n
krovište	n
rukometašica	ž
nastojanje	n
zvonik	n
okretaj	n
izazov	n
kopča	n
šum	n
gimnastika	n
tiskovina	n
astma	n
seka	ž
izvjestitelj	ž
uzgajivač	ž
klađenje	n
atribut	n
hotelijer	ž
vjeverica	ž
parola	n
jedro	n
astronomija	n
useljenje	n
iskaznica	n
poziv	n
civil	ž
turist	ž
glumište	n
množina	n
povezivanje	n
disko	n
željezara	n
konstruktor	ž
vrlina	n
počinitelj	ž
izdanje	n
higijena	n
otmičar	ž
kotačić	n
odziv	n
sredina	n
razgradnja	n
opstanak	n
kreda	n
mrlja	n
tinejdžer	ž
komuniciranje	n
hokejaš	ž
ratnik	ž
razrada	n
licemjerje	n
badminton	n
zapovjedništvo	n
odmazda	n
odbacivanje	n
prisustvo	n
gledanost	n
narušavanje	n
vrsta	n
smrtnost	n
dogma	n
prikolica	n
cimet	n
dječak	ž
patnja	n
osmina	n
insekt	n
donator	ž
desetljeće	n
predjelo	n
zasjedanje	n
opseg	n
odmorište	n
mrva	n
pekara	n
izbor	n
mudo	n
arbitraža	n
glad	n
stoka	n
zastara	n
podsjetnik	n
odgovor	n
kemija	n
slijepac	ž
etaža	n
bavljenje	n
suradnik	ž
pretpostavka	n
suosnivač	ž
prostor	n
satelit	n
posjetitelj	ž
ministarstvo	n
upornost	n
teškoća	n
prosvjeta	n
pričanje	n
projekt	n
pučanstvo	n
štediša	ž
balkon	n
zrak	n
cijev	n
repriza	n
tamnica	n
radij	n
bježanje	n
crta	n
latinica	n
grad	n
tjeranje	n
selidba	n
svijet	n
zid	n
pravo	n
hrana	n
reforma	n
osjećaj	n
šara	n
konkurencija	n
prijetnja	n
puč	n
željezo	n
homoseksualnost	n
kultura	n
živac	n
turnir	n
odnos	n
upaljač	n
džep	n
skromnost	n
suicid	n
flora	n
kampanja	n
referenca	n
dadilja	ž
parfem	n
boksač	ž
odigravanje	n
tijelo	n
providnost	n
odjava	n
skica	n
pločica	n
stupanje	n
novogradnja	n
posredstvo	n
gnojivo	n
zdenac	n
pređa	n
priljev	n
odvjetnik	ž
sloga	n
pokaz	n
stan	n
farsa	n
povjerenik	ž
kvota	n
intuicija	n
ulica	n
dalekovod	n
degustacija	n
izlagač	ž
agnostik	ž
penjanje	n
krik	n
padina	n
pobjednik	ž
zapažanje	n
suradnja	n
šahist	ž
hlađenje	n
remen	n
kilogram	n
natječaj	n
prosjak	ž
student	ž
sjedenje	n
zaljubljenik	ž
povreda	n
sutkinja	ž
naprezanje	n
redovnica	ž
bob	n
auspuh	n
zrcalo	n
migracija	n
sugrađanin	ž
jutro	n
nagađanje	n
prijevoz	n
olovka	n
govedina	n
inicijator	ž
presing	n
pozitiv	n
osvjetljenje	n
instinkt	n
cifra	n
putovnica	n
nosivost	n
lutrija	n
grijač	n
galama	n
operater	ž
saznanje	n
agregat	n
dnevnik	n
orgazam	n
jeka	n
čitanje	n
proizvođač	ž
preseljenje	n
zločinac	ž
razbojnik	ž
krzno	n
preljev	n
karcinom	n
car	ž
krijumčarenje	n
sućut	n
ozbiljnost	n
krv	n
vlakno	n
ostvarivanje	n
autizam	n
revolucionar	ž
pučina	n
djevojka	ž
uzbuđenje	n
kancelarka	ž
plakat	n
pomutnja	n
ograničenost	n
kompromis	n
ivančica	n
maraton	n
prosudba	n
vizualizacija	n
nestanak	n
stanka	n
sjedalica	n
ugljikohidrat	n
špekulacija	n
stvar	n
očitovanje	n
vic	n
veljača	n
pedagogija	n
savjetovalište	n
degradacija	n
izvedenica	n
blizanka	ž
pismo	n
uzimanje	n
ušće	n
hobi	n
ugođaj	n
uključenost	n
licencija	n
kompjutor	n
težnja	n
abeceda	n
ručka	n
milosrdnica	ž
pripadnik	ž
koncert	n
rijeka	n
mozaik	n
intencija	n
ambulanta	n
pobačaj	n
učvršćivanje	n
bahatost	n
proza	n
projekcija	n
posjetilac	ž
razlaz	n
keramika	n
neznanje	n
agonija	n
libido	n
podražaj	n
ožiljak	n
predgrupa	n
potencijal	n
pogled	n
